#####C#####
#          
#          
# #### ####
  #  #    #
# # M#    #
# #  #    #
# ######## 