###C######
          
          
  #####   
  #   #   
  # M #   
  #   #   
  #####   