##C#####################################
##         ######## ############       #
##          ####### #            ##### #
## ################ ################## #
## #######                       ##### #
## ####### ############### ######   ## #
## #######         M###### ###    #  # #
## ################# ##### ### ## # ## #
## ##### # ######    #####     ## # ## #
## ##### #######  ## ##############  # #
## ##### ####    ### #########    ## # #
##       #### ###### ######### ##### # #
###        ## ###### ######### ##    # #
### ######### ######     ##### ## #### #
### ######### ######## ## #### ##      #
###             ###### ## #### ####### #
###################### ## #   ##       #
###################### ######### ##### #
######################           #     #
########################################