######C######################
#      ##         #    #    #
#      ##  #####  #  # # #  #
#    ###      ##  #  # ###  #
#    ###   ## ##     #      #
#          #####  ######    #
# ######  ##           # ####
#  #      ##  ###   ####    #
#####  ## #     ##  ##     ##
#      #  ##   ##   ###   ###
#  # # # ####   ## ##### ####
#### #   ######  #####    M##
#    ###     ##    ##########
#############################