# C ######   #########################     #######
#   ##       #####            ######## ###       #
#   ## #####  ###  ##### ####  ####### ###   M   #
#        # #   #  ###### ###    ###  # ###       #
# ###### #     # ### ### ##  ####      ###       #
# ####   ### ######  ### ###  ##  ####   #### ####
#   ######    ###    #   ###       ###      #    #
# # ## #   ## ##  ## ###   ##  ################# #
#   #  #####  ##  ## #   # #####     #   #   #   #
# ###         ### #  # ### ##### ### # # # # # # #
  ### ###### #### #  # ### ##    ### # # # # # # #
   #  ####   #### ## # #         ### # # # # # # #
        ###        # ###   ##    ###   #   #   # #
################   #     #########################