########C#
#     #  #
 #####   #
#       ##
#    #####
#       ##
######    
#       M#
        ##
###       